    XXXXXXXXXXXXX
  XXXXXXXXXXXXXXXXX
 XXXXXXXXXXXXXXXXXXX
XXXXXXXXXXXXXXXXXXXXX
XXXXXXXXXXXXXXXXXXXXX
XXXXXXXXXXXXXXXXXXXXX