      XXXXXXXXXXXXX
    XXXXXXXXXXXXXXXXX
   XXXXXXXXXXXXXXXXXXX
  XXXXXXXXXXXXXXXXXXXXX
 XXXXXXXXXXXXXXXXXXXXXXX
XXXXXXXXXXXXXXXXXXXXXXXXX
XXXXXXXXXXXXXXXXXXXXXXXXX